................................................................................
.#####....#####.....#####....#####.....#####....#####.....#####....#####........
.#####....#####.....#####....#####.....#####....#####.....#####....#####........
................................................................................
................................................................................
....##########.........##########.........##########.........##########.........
....##########.........##########.........##########.........##########.........
................................................................................
................................................................................
..#....#....#....#....#....#....#....#....#....#....#....#....#....#....#.......
..#....#....#....#....#....#....#....#....#....#....#....#....#....#....#.......
................................................................................
................................................................................
......##########.........##########.........##########.........##########.......
......##########.........##########.........##########.........##########.......
................................................................................
................................................................................
.....#####....#####.....#####....#####.....#####....#####.....#####....#####....
.....#####....#####.....#####....#####.....#####....#####.....#####....#####....
................................................................................
................................................................................
.#####....#####.....#####....#####.....#####....#####.....#####....#####........
.#####....#####.....#####....#####.....#####....#####.....#####....#####........
................................................................................
................................................................................
....##########.........##########.........##########.........##########.........
....##########.........##########.........##########.........##########.........
................................................................................
................................................................................
..#....#....#....#....#....#....#....#....#....#....#....#....#....#....#.......
..#....#....#....#....#....#....#....#....#....#....#....#....#....#....#.......
................................................................................
................................................................................
......##########.........##########.........##########.........##########.......
......##########.........##########.........##########.........##########.......
................................................................................
................................................................................
.....#####....#####.....#####....#####.....#####....#####.....#####....#####....
.....#####....#####.....#####....#####.....#####....#####.....#####....#####....
................................................................................
................................................................................
.#####....#####.....#####....#####.....#####....#####.....#####....#####........
.#####....#####.....#####....#####.....#####....#####.....#####....#####........
................................................................................
................................................................................
....##########.........##########.........##########.........##########.........
....##########.........##########.........##########.........##########.........
................................................................................
................................................................................
..#....#....#....#....#....#....#....#....#....#....#....#....#....#....#.......
..#....#....#....#....#....#....#....#....#....#....#....#....#....#....#.......
................................................................................
................................................................................
......##########.........##########.........##########.........##########.......
......##########.........##########.........##########.........##########.......
................................................................................
................................................................................
.....#####....#####.....#####....#####.....#####....#####.....#####....#####....
.....#####....#####.....#####....#####.....#####....#####.....#####....#####....
................................................................................
