//morerandomobstacles
##.#.#...#..##.#.#...##.#.......#..............#.#...#..#...
#.####.##..#.#......#####....##.#...#..##.##...#.####....###
######....#####.#.#.#######..#####..#.####.#..#.###.##....##
.........#.#....##........#...#.#...#.....####.#.#..#.....##
..#..#.#....#..##..#.###...##.#.....#..##....##..#..........
#...##..#######....##.#####.#####...####..#####..####.#.#..#
#....#.#########..#.#.#######.######.#....##.########.......
#.......#...........#....#.#.#..#.#.#..##...#.........##....
###..#...##.......#...#.......##......#.#..##..#......##.#..
..#..#.#..#....####.....#..##...###...##.##.#.##..#......#..
.###........#.#.##.#..#...##....#...##...#......#.#......#..
##....#.#........##...#......##..#......###.#........#..#...
..##......#........#.##.....#.##.###....#......#..#.........
.######..#######....#...##.###.####.#.##....########.###....
....#..#########...##..#.##########..#.#.#..####.#####..#..#
..#.#..#...#...#...#.....#.#.##.....##......#..#.........#..
........#.....##.....#...##...#.................#.#.#..#...#
.....######..###.##.....##.###...#####.....#####....#####..#
#.#..##.##..########..#...###.##..##.#.#.#.###.#.#..#####...
.#.###.......#.#...##...#..#.......##.#....##..#.#..#...#.#.
.........#...#.#.###.#.#.#..#..........#......##.....#......
.#####....#.##......#####.#..#####..#.#.##.#.####.#....#.###
.####.#..######.#...#####....#####.#.######..#..#####..##..#
.#.........#...........##.#.#.#..#........#.#.#..#...#....#.
..#...#....#..#..#.....#..#.......#..####............#.....#
...####.######.#.#.#.#.###...##.#.##.#....#.##########...#..
.#..#.#######......#....###.#.###..##.#.....#..######...##..
..#..#......##...#..#..#.##.......###.#..#....#...#...#.....
#...#....##...........#...#.###...#.......##....#.##.#.#..#.
..#.#..#...##.#..#...##.##..#####.#..#.#.#.....#....###.....
..#..#.#....#.####...##.#..#....###............#....###..#..
...#..#...#.#.#....###........#.....#.......#.#....#.......#
###.....#.#............#.............#..#..##..##.#....#..#.
..#....######..#.........#######..###....#########.###....##
.#.#.####.####.#.#.#...#.######..###..##..###########..#..#.
...#......#.#...#..............#.................#.#....#..#
....#...#..#...........##.###...#..#.#...##....#...........#
....#######..#.####...#.###.##.########...###.##..###.#.#...
......####....#####......####.....####.....#####.....#.#...#
..............#....#....#....#...#..#...........#....#.#....
.#.....#.............###......#..#..#.....#..##...#.....#...
...####...#####......##.......#####.##...###......###...#.##
#####.....##.##...#..##.#......#.##.###.#####...##..#....###
.#...#..#.....#.....#..##...........#..#.............###....
....#.#....#....##.#...#.............#.#.....#..#.#...#.....
...#..##.#####.##...#..#.####..##.#.......###.######...##...
....###########.........########...#......######.###.......#
.....#.###.#....#.#....#...#.....##.........#......#.#......
....#.............##.#..#.....#.#..#.##....#...#.........#..
#.#..#.#...##....#....#...##...##...####..##...##.#....#.#..
..#....#.#.....#.#....#....#...###.####...#....#....#..#....
.##..#..........#.#.......#..##.....##.##..#..#..##.....#...
..#...#.............#...........#.##...#.....#......##......
..###.##.#.#.##........#.#.#..##.##..##...#.######..#....#..
......####.####.##.#..#..###.#####.##...#.....####.###......
..#....#.....#..........#.#...#...#.............#.#...#.#...
#..........###..#...............#.....#..#...#.#....#.....##
.#########.##...###.#...#####..##.###......##.##....##.###..
.#.#..####..#####.#.....#####..#####.#.....#####.#.#####....
#.#.....#.#..#........#.#....#.........####....##.......#.#.
