// Corridor map - forces agents through narrow passages
############.############
............#............
.##########.#.##########.
.##########.#.##########.
.##########.#.##########.
............#............
############.############