// Demo map - 10x10 grid with obstacles
..........
..#....#..
..#....#..
..........
....##....
....##....
..........
..#....#..
..#....#..
..........