// Large map - 20x20 grid
....................
.#####....#####.....
.#####....#####.....
....................
....................
....##########......
....##########......
....................
....................
..#....#....#....#..
..#....#....#....#..
....................
....................
......##########....
......##########....
....................
....................
.....#####....#####.
.....#####....#####.
....................